9 6
######
#    #
# *  #
##+0 #
# + ##
# + # 
# + # 
# $ # 
##### 
