9 9
  #####  
 ##   ## 
 #  *$$##
##* #$*$#
#   #$$$#
# *###* #
#  * * ##
##0    # 
 ####### 
