8 10
   #######
  ##  # 0#
  #   #  #
  #* * * #
  # *##  #
### * # ##
#$$$$$  # 
######### 
