8 9
#####    
#   #####
# # #   #
# *   * #
#$$#*#*##
#$0*   # 
#$$  ### 
######   
