6 9
  ####   
###  ####
#       #
#0*+++$ #
#       #
#########
