9 7
  #### 
  #  # 
###* ##
#  + 0#
#  +  #
#  + ##
###+ # 
  #$## 
  ###  
