8 8
 #####  
 #  0###
## #*  #
# +$ $ #
#  ** ##
### #$# 
  #   # 
  ##### 
