10 10
 #########
 #  ##   #
 #  *  # #
 #  ##+  #
 ## #$$*##
### #0# ##
#   +$ * #
# # ##   #
#   ######
#####     
