7 7
#######
#$ $ $#
# *** #
#$*0*$#
# *** #
#$ $ $#
#######
