8 6
##### 
##  # 
# 0*# 
##* ##
## * #
#$*  #
#$$+$#
######
