12 13
 #########   
 #   ##  ####
 # *        #
 ##*### ##  #
 #  ## + # ##
 # *$$$$$$ # 
## ### $ # # 
#     *###*# 
#   #    *0# 
#####*# #### 
    #   #    
    #####    
