12 15
       ########
       #  #   #
 ####### **$$$#
 #        #$$$#
 # ######*#$$$#
## #      #$$$#
#  # #* * #####
# # * * * #    
# 0  * #  #    
#####* ** #    
    #     #    
    #######    
