10 6
  ####
###  #
# ** #
#    #
#$$$##
#$$$# 
# * # 
#***# 
# 0 # 
##### 
