9 8
  ####  
###  ## 
# *$* ##
#  *$  #
#0#$*$ #
# $*$ ##
# *$* # 
##  ### 
 ####   
