10 9
   ####  
####  ## 
#   *  # 
#  +++ # 
#  $ $ ##
## + +  #
 ##+++  #
  # * ###
  # 0 #  
  #####  
