7 9
######   
#    #   
# ***##  
#  #$$###
##  $$* #
 # 0    #
 ########
