8 7
#######
#$$*$$#
#$$#$$#
# *** #
#  *  #
# *** #
#  # 0#
#######
