5 5
#####
#0  #
# * #
#  $#
#####